1111111111
1P00000001
1000000001
1000000101
10000001C1
10000001E1
10000001C1
1111111111
1000000101
1111111111