111111111111111111111111111
100000000000010000000000001
101111011111010111110111101
1C11110111110101111101111C1
101111011111010111110111101
100000000000000000000000001
101111011011111110110111101
101111011011111110110111101
100000M11000010000110000001
111111011111010111110111111
111111011111010111110111111
111111011111010111110111111
111111011000000000110111111
111111011011101110110111111
111111011010000010110111111
1111110110100E0010110111111
111111011011111110110111111
111111011000000000110111111
111111011011111110110111111
111111011011111110110111111
100000000000010000000000001
101111011111010111110111101
101111011111010111110111101
1C00110000000P00000001100C1
111011011111111111110110111
111011011111111111110110111
100000011111111111110000001
101111111111111111111111101
100000000000000000000000001
111111111111111111111111111